# # # # # # # # # # # # #
# ~ ~ ~ B # # # ~ B ~ ~ #
# @ . . . # # # . . . = #
# . . # * S . . * # . . #
# . # # # # . # # # . . #
# . . = # # + # # # . ! #
# # # # # # # # # # # # #
