# # # # # # # # # # # # #
# ~ ~ ~ ~ # # # ~ B ~ ~ #
# @ . . . # # # . . . . #
# . . # * S . . * # . . #
# . # # # # . # # # . . #
# . . = # # + # # # . ! #
# # # # # # # # # # # # #
