# # # # # # # # # # # # #
# ~ ~ ~ ~ # # # ~ B ~ ~ #
# @ . . . # # # . . . = #
# . . # * S . . * # . . #
# . # # # # . # # # . . #
# . . = # # + # # # . ! #
# # # # # # # # # # # # #
