# # # # # # # # # # # # #
# ~ ~ ~ B # # # ~ ~ ~ ~ #
# @ . . . # # # . . . = #
# . . # * S . . * # . . #
# . # # # # . # # # . . #
# . . = # # + # # # . ! #
# # # # # # # # # # # # #
