# # # # # # # # # # # # #
# ~ ~ ~ ~ # # # ~ B ~ ~ #
# @ . . . # # # . . . . #
# . . # * S . . * # . . #
# . # # # # . # # # E . #
# . . = # # + # # # . ! #
# # # # # # # # # # # # #
