# # # # # # # # # # # # #
# ~ ~ ~ ~ ~ ~ ~ ~ ~ ~ ~ #
# ~ ~ ~ B ~ ~ ~ ~ B ~ ~ #
# @ . . . # # # . . . = #
# . . # * S . . * # . . #
# . # # # # . # # # . . #
# . . = # # + # # # . ! #
# # # # # # # # # # # # #
