# # # # # # # # # # # # #
# ~ ~ ~ ~ ~ ~ ~ ~ ~ ~ ~ #
# ~ ~ ~ B ~ ~ ~ ~ B ~ ~ #
# @ . . . # # # . = . . #
# . . # * S . . * # . . #
# . # # # # . # # # . . #
# . . = # # + # # # . ! #
# # # # # # # # # # # # #
