# # # # # # # # # # # # # # # # # # # # # # # # # #
# ~ ~ ~ ~ ~ ~ ~ ~ ~ ~ ~ ~ ~ ~ ~ ~ ~ ~ ~ ~ ~ ~ ~ ~ #
# ~ ~ ~ B ~ ~ ~ ~ ~ ~ B ~ ~ ~ ~ ~ B ~ ~ ~ ~ ~ ~ ~ #
# = . . . . . + . . . = . . . . . . . . . . = . . #
# . . # * S . . * # . . . . . . # * . . # # # . . #
# S # # # # . # # # S . # = . # # # # . # # # . . #
# . . @ # # = . # # . # # . . . . . = . . . # ! ! #
# # # # # # # # # # # # # # # # # # # # # # # # # #