# # # # # # # # # # # # # # # # # # # # # # # # # #
# ~ ~ ~ ~ ~ ~ ~ ~ ~ ~ ~ ~ ~ ~ ~ ~ ~ ~ ~ ~ ~ ~ ~ ~ #
# ~ ~ ~ B ~ ~ ~ ~ ~ ~ ~ ~ ~ ~ ~ ~ B ~ ~ ~ ~ ~ ~ ~ #
# @ . . . . . = . # . . . * . . . . . . . . = . . #
# . . # * S . . * # . . . . . . # * . . # # # . . #
# . # # # # . # # # S . # = . # # # # . # # # . . #
# . . = # # + . . . . # # . . # # # # + . . . . ! #
# # # # # # # # # # # # # # # # # # # # # # # # # #